---------------------

MMPPBPPMM   MMPPBPPMM
M   Y   M   M   Y   M
  YYYYY   R   YYYYY
YYYBBBYYYRRRYYYBBBYYY
  YYYYY   R   YYYYY
M   Y   M   M   Y   M
MMPPBPPMM   MMPPBPPMM